[{"level":1,
 "model":0,
 "move":20,
 "time":0,
 "width":9,
 "height":9,
 "food":[1,1,2,1,1,0,0,0,0,
         2,1,1,2,0,0,0,0,0,
         1,2,1,0,0,0,0,0,0,
         0,1,2,0,0,0,0,3,0,
         0,0,0,0,0,0,0,2,0,
         0,0,0,0,0,0,0,2,0,
         0,0,0,0,0,0,2,3,2,
         0,0,0,0,0,0,0,2,0,
         0,0,0,0,0,0,0,0,0],
 "tile":[0,0,0,0,0,0,0,0,0,
         0,0,0,0,0,0,0,0,0,
         0,0,0,0,0,0,0,0,0,
         0,0,0,0,0,0,0,0,0,
         0,0,0,0,0,0,0,0,0,
         0,0,0,0,0,0,0,0,0,
         0,0,0,0,0,0,0,0,0,
         0,0,0,0,0,0,0,0,0,
         0,0,0,0,0,0,0,0,0]
 }]